2 2 2 2 2 2 2 2 2 2 2 2 2 2 2 2
2 2 2 2 2 2 2 2 2 2 2 2 2 2 2 2
2 2 2 2 2 2 2 2 2 2 2 2 2 2 2 2
5 5 5 5 5 2 2 2 2 2 2 5 5 5 5 5
0 0 0 0 5 5 5 5 3 5 5 5 0 0 0 0
0 0 0 0 3 3 3 3 3 0 0 0 0 0 0 0
0 4 4 4 3 4 4 4 0 0 0 0 0 0 0 0
0 4 1 1 3 1 1 4 0 0 0 0 0 0 0 6
0 4 1 3 3 3 1 4 0 0 0 0 6 0 6 6
0 4 1 3 3 3 1 4 0 0 0 0 0 6 6 6
0 4 1 3 3 3 1 4 0 0 0 0 6 6 6 6
0 4 1 1 1 1 1 4 0 0 0 6 6 6 6 6