7 7 7 7 7 7 7 7 7 7 7 7 7 7 7 7 7 7 7 7 7 7 7 7 7 7 7 7 7 7 7 7 7 7 7 7 7 7 7 7 7 7 7 7 7 7 7 7 7 7 
7 7 7 7 7 7 7 7 7 7 7 7 7 7 7 7 7 7 7 7 7 7 7 7 7 7 7 7 7 7 7 7 7 7 7 7 7 7 7 7 7 7 7 7 7 7 7 7 7 7 
7 7 7 7 7 7 7 7 7 1 1 1 1 1 1 1 1 1 1 1 1 1 1 7 1 1 1 1 1 1 1 1 1 1 1 1 7 7 7 7 7 7 7 7 7 7 7 7 7 7 
7 7 7 1 1 1 1 7 1 1 1 1 1 7 1 1 1 1 1 1 1 1 1 1 1 1 1 1 1 1 7 1 1 1 1 1 1 1 7 7 7 7 7 7 7 7 7 7 7 7 
7 7 1 1 1 7 1 1 1 1 1 1 1 1 1 1 1 1 7 1 1 1 1 1 1 1 1 1 1 1 1 1 1 1 1 1 7 1 1 7 7 7 7 7 7 7 7 7 7 7 
7 7 1 1 1 1 1 1 1 1 1 1 1 1 1 1 1 1 2 2 2 2 2 2 2 2 2 1 1 7 1 1 1 7 1 1 1 1 1 1 7 7 7 7 7 7 7 7 7 7 
7 7 1 1 7 1 1 1 7 1 1 7 1 1 1 7 1 1 2 4 4 4 4 4 4 4 2 1 1 1 1 1 1 1 1 7 1 1 1 1 7 7 7 7 7 7 7 7 7 7 
7 1 1 7 1 1 1 1 1 1 1 1 7 1 1 1 1 1 2 4 4 4 4 4 4 4 2 1 1 1 1 7 1 1 1 1 1 1 1 1 1 7 7 7 7 7 7 7 7 7 
7 1 1 1 1 1 7 1 1 1 1 1 1 1 2 2 2 2 2 2 4 2 2 2 2 2 2 1 1 1 1 1 1 1 1 1 1 7 1 1 1 1 7 7 7 7 7 7 7 7 
7 7 1 1 1 1 1 1 1 1 1 1 1 1 2 4 4 4 2 4 4 4 4 4 4 4 2 2 2 2 2 2 2 2 2 2 2 2 1 1 1 1 7 7 2 2 2 2 2 7 
7 1 1 1 7 1 1 1 7 1 1 1 1 1 2 4 4 4 4 4 4 4 2 1 4 4 2 4 4 4 4 4 4 2 4 4 4 2 7 1 1 1 1 7 2 4 4 4 2 7 
7 1 1 1 1 1 1 1 1 1 1 7 1 1 2 4 4 4 2 4 4 4 2 1 4 4 2 4 4 4 4 4 4 4 4 4 4 2 1 1 1 1 1 7 2 4 4 4 2 7 
7 1 7 1 1 1 1 1 1 1 1 1 4 1 2 2 2 2 2 2 2 2 2 1 4 4 2 2 2 2 2 2 2 2 4 4 4 2 1 1 1 1 1 7 2 4 4 4 2 7
7 1 1 1 1 7 1 1 7 1 1 1 1 1 1 1 1 1 1 1 1 1 1 1 4 4 2 4 4 4 4 4 4 2 4 4 4 2 1 1 7 1 1 7 2 2 4 2 2 2 
7 1 1 1 1 1 1 1 1 1 1 1 1 2 2 2 2 2 1 1 7 1 1 1 4 4 2 4 4 4 4 4 4 2 4 4 4 2 1 1 1 1 1 1 4 4 4 4 4 2
7 1 1 1 1 1 1 1 1 1 7 1 1 2 4 4 4 2 1 1 1 1 1 1 4 4 2 4 4 2 2 2 2 2 2 4 2 2 1 1 1 1 1 1 4 2 2 4 4 2
7 1 1 7 1 1 7 1 1 1 1 1 1 2 4 4 4 2 4 4 4 4 4 4 4 4 2 4 4 4 4 4 4 2 4 4 4 2 1 1 1 1 7 7 4 4 2 4 4 2 
7 1 1 1 1 1 1 1 1 1 1 1 1 2 4 4 4 2 4 5 5 5 5 4 4 4 2 4 4 2 4 4 4 4 4 4 4 2 1 1 1 7 1 7 2 4 2 2 2 2 
7 1 1 1 1 1 1 1 1 6 6 6 1 2 2 4 2 2 4 2 2 2 2 2 4 4 2 4 4 2 4 4 4 2 4 4 4 2 1 1 1 1 1 7 2 4 4 4 2 7 
7 1 7 1 1 1 1 1 6 6 3 6 1 1 2 4 2 4 4 4 2 4 4 2 4 4 2 2 2 2 2 4 2 2 2 2 2 2 1 1 7 1 1 7 2 4 4 4 2 2 
7 1 1 1 1 1 7 6 6 3 3 3 6 1 2 4 4 4 4 4 4 4 4 2 4 4 1 1 1 1 1 4 1 1 1 1 1 1 1 1 1 1 1 7 2 4 4 4 4 2 
7 1 1 1 1 6 6 3 3 3 3 3 6 1 2 2 2 4 4 4 2 4 4 2 4 4 4 4 4 4 4 4 4 4 4 4 4 1 1 1 1 1 1 7 2 2 2 2 4 2 
7 1 1 1 1 6 3 3 3 3 3 3 6 1 1 1 2 2 2 2 2 2 2 2 4 4 4 4 4 4 4 4 4 4 4 4 4 1 1 1 1 1 1 7 2 4 4 4 4 2 
7 1 1 1 1 6 6 3 3 3 3 6 6 1 1 1 1 1 1 1 1 1 1 1 4 4 1 2 2 2 2 2 2 2 2 4 4 1 7 1 7 1 1 7 2 4 4 4 4 2 
7 1 1 7 1 1 6 6 6 6 4 6 4 4 4 4 4 4 4 4 4 4 4 4 4 4 1 2 4 4 4 2 4 4 2 4 4 1 1 1 1 1 1 7 2 4 4 4 4 2
7 1 1 1 1 1 1 1 1 1 4 4 4 4 4 4 4 4 4 4 4 4 4 4 4 4 1 2 4 4 4 4 4 4 2 4 4 1 7 1 1 1 1 7 2 2 4 2 2 2
7 1 7 1 1 1 1 1 1 1 1 1 1 1 1 1 1 1 1 1 1 1 1 1 1 1 1 2 4 4 4 2 4 4 2 4 4 1 1 1 1 1 1 7 2 4 4 4 2 7 
7 1 1 1 7 1 1 1 7 1 1 1 1 7 1 1 1 1 1 7 1 1 1 1 7 1 1 2 2 4 2 2 2 2 2 4 4 1 1 7 1 7 1 7 2 4 4 4 2 7 
7 1 1 1 1 1 7 1 1 1 1 1 1 1 7 1 1 1 1 1 1 1 1 1 1 1 1 1 1 4 1 1 1 1 1 4 4 1 1 1 1 1 1 7 2 4 4 4 2 7 
7 1 7 1 1 1 1 1 1 1 1 1 1 1 1 1 1 1 1 1 1 1 1 7 1 1 1 1 1 4 4 4 4 4 4 4 4 1 1 1 1 1 1 7 2 2 4 2 2 7 
7 7 1 7 1 1 1 1 1 1 1 7 1 1 1 1 1 7 1 1 1 1 1 1 1 1 1 7 1 4 4 4 4 4 4 4 4 4 4 4 4 4 4 4 4 4 4 7 7 7
7 7 7 1 1 7 1 1 1 1 1 1 1 7 1 1 1 1 1 1 1 7 1 1 1 1 1 1 1 1 1 1 1 7 1 1 1 7 1 1 1 1 7 7 7 7 7 7 7 7 
7 7 7 7 7 7 7 7 7 1 1 1 1 1 1 1 1 1 1 1 1 1 1 1 1 1 1 1 1 1 7 1 1 1 7 1 1 1 1 7 7 7 7 7 7 7 7 7 7 7 
7 7 7 7 7 7 7 7 7 7 7 1 7 7 7 7 7 7 7 7 7 7 7 7 7 7 7 7 7 7 7 7 7 7 7 7 7 7 7 7 7 7 7 7 7 7 7 7 7 7 
7 7 7 7 7 7 7 7 7 7 7 1 7 7 7 7 7 7 7 7 7 7 7 7 7 7 7 7 7 7 7 7 7 7 7 7 7 7 7 7 7 7 7 7 7 7 7 7 7 7 
7 7 7 7 7 7 7 7 7 7 7 1 7 7 7 7 7 7 7 7 7 7 7 7 7 7 7 7 7 7 7 7 7 7 7 7 7 7 7 7 7 7 7 7 7 7 7 7 7 7 
7 7 7 7 7 7 7 7 7 7 7 1 1 7 7 7 7 7 7 7 7 7 7 7 7 7 7 7 7 7 7 7 7 7 7 7 7 7 7 7 7 7 7 7 7 7 7 7 7 7 
7 7 7 7 7 7 7 7 7 7 7 7 1 7 7 7 7 7 7 7 7 7 7 7 7 7 7 7 7 7 7 7 7 7 7 7 7 7 7 7 7 7 7 7 7 7 7 7 7 7 
7 7 7 7 7 7 7 7 7 7 7 7 1 7 7 7 7 7 7 7 7 7 7 7 7 7 7 7 7 7 7 7 7 7 7 7 7 7 7 7 7 7 7 7 7 7 7 7 7 7 
7 7 7 7 7 7 1 1 1 1 1 1 1 7 7 7 7 7 7 7 7 7 7 7 7 7 7 7 7 7 7 7 7 7 7 7 7 7 7 7 7 7 7 7 7 7 7 7 7 7 
7 7 7 7 7 7 1 7 7 7 7 7 7 7 7 7 7 7 7 7 7 7 7 7 7 7 7 7 7 7 7 7 7 7 7 7 7 7 7 7 7 7 7 7 7 7 7 7 7 7 
1 1 1 1 1 1 1 1 1 1 1 1 1 1 1 1 1 1 1 1 1 1 1 1 1 1 1 1 1 1 1 1 1 1 1 1 1 1 1 1 1 1 1 1 1 1 1 1 1 7 
1 1 1 1 1 1 1 1 1 1 1 1 1 1 1 1 1 1 1 1 1 1 1 1 1 1 1 1 1 1 1 1 1 1 1 1 1 1 1 1 1 1 1 1 1 1 1 1 1 7 
1 1 1 1 1 1 1 1 1 1 1 1 1 1 1 1 1 1 1 1 1 1 1 1 1 1 1 1 1 1 1 1 1 1 1 1 1 1 1 1 1 1 1 1 1 1 1 1 1 7 
1 1 1 1 1 1 1 1 1 1 1 1 1 1 1 1 1 1 1 1 1 1 1 1 1 1 1 1 1 1 1 1 1 1 1 1 1 1 1 1 1 1 1 1 1 1 1 1 1 7 
1 1 1 1 1 1 1 1 1 1 1 1 1 1 1 1 1 1 1 1 1 1 1 1 1 1 1 1 1 1 1 1 1 1 1 1 1 1 1 1 1 1 1 1 1 1 1 1 1 7 
1 1 1 1 1 1 1 1 1 1 1 1 1 1 1 1 1 1 1 1 1 1 1 1 1 1 1 1 1 1 1 1 1 1 1 1 1 1 1 1 1 1 1 1 1 1 1 1 1 7 
1 1 1 1 1 1 1 1 1 1 1 1 1 1 1 1 1 1 1 1 1 1 1 1 1 1 1 1 1 1 1 1 1 1 1 1 1 1 1 1 1 1 1 1 1 1 1 1 1 7 
1 1 1 1 1 1 1 1 1 1 1 1 1 1 1 1 1 1 1 1 1 1 1 1 1 1 1 1 1 1 1 1 1 1 1 1 1 1 1 1 1 1 1 1 1 1 1 1 1 7 
1 1 1 1 1 1 1 1 1 1 1 1 1 1 1 1 1 1 1 1 1 1 1 1 1 1 1 1 1 1 1 1 1 1 1 1 1 1 1 1 1 1 1 1 1 1 1 1 1 7 
